3 33
 7  5  4  1  9  2  8  6  3 
 6  9  1  3  4  8  7  2  5
 2  8  3  5  6  7  1  4  9
 8  7  5  4  2  1  3  9  6
 3  1  9  6  7  5  2  8  4
 4  6  2  8  3  9  5  7  1 
 9  2  6  7  5  3  4  1  8
 5  4  8  2  1  6  9  3  7
 1  3  7  9  8  4  6  5  2

3 6
8 6
4 8
1 3
1 6
5 1
7 1
1 8
1 1
8 0
2 3
7 8
4 2
4 1
2 8
4 0
3 0
6 7
2 7
1 0
4 7
0 0
2 6
3 1
5 8
7 6
8 1
5 4
3 5
0 7
3 8
6 5
3 3