3 33
 4  6  8  5  3  1  9  7  2 
 1  3  9  2  7  6  8  5  4
 5  2  7  8  9  4  3  1  6
 2  1  5  4  8  9  6  3  7
 3  7  6  1  5  2  4  9  8
 9  8  4  7  6  3  5  2  1 
 7  9  1  6  4  5  2  8  3
 8  4  3  9  2  7  1  6  5
 6  5  2  3  1  8  7  4  9

1 2
1 1
5 5
5 0
0 7
3 4
1 4
0 3
0 6
8 3
6 4
7 7
6 0
1 6
6 5
4 8
3 8
2 6
1 0
0 4
2 3
0 8
8 1
3 7
2 4
3 6
1 8
6 8
6 7
2 0
5 8
7 0
7 8