3 33
 9  2  3  8  5  6  7  1  4 
 1  6  4  7  3  2  5  8  9
 5  7  8  9  4  1  3  6  2
 3  4  5  6  7  8  2  9  1
 7  9  1  4  2  5  8  3  6 
 6  8  2  1  9  3  4  7  5
 2  1  6  5  8  7  9  4  3
 4  3  7  2  1  9  6  5  8
 8  5  9  3  6  4  1  2  7

1 4
3 2
8 5
2 0
4 0
4 6
7 1
7 4
6 0
8 7
3 8
7 6
3 3
7 8
0 6
6 6
8 4
2 6
4 2
2 3
4 7
8 1
7 0
3 7
1 2
6 5
7 2
1 1
0 4
0 8
2 4
8 6
6 7