3 33
 5  2  9  1  8  4  6  7  3 
 6  7  8  2  3  9  4  5  1
 1  4  3  5  6  7  2  8  9
 7  9  6  3  1  8  5  2  4 
 2  5  1  4  9  6  7  3  8
 8  3  4  7  5  2  1  9  6
 9  1  7  8  4  5  3  6  2
 3  6  2  9  7  1  8  4  5
 4  8  5  6  2  3  9  1  7

1 4
6 4
3 0
4 5
5 2
5 5
3 8
8 4
6 2
2 4
8 7
6 8
0 6
4 0
8 1
7 5
2 6
6 1
1 8
7 3
3 7
0 5
4 4
4 3
5 4
1 2
7 8
5 8
6 6
8 8
2 3
0 1
2 0