3 33
 8  6  5  7  1  3  2  9  4 
 9  4  3  2  6  5  7  8  1
 2  1  7  9  4  8  5  3  6
 3  9  8  1  7  4  6  2  5 
 5  7  4  6  8  2  9  1  3
 1  2  6  3  5  9  4  7  8
 6  3  1  4  2  7  8  5  9
 4  5  2  8  9  1  3  6  7
 7  8  9  5  3  6  1  4  2

5 2
4 2
2 8
6 3
8 4
1 7
2 7
4 5
5 7
6 6
3 1
2 5
7 6
7 1
8 2
1 2
3 6
2 3
6 8
1 6
3 0
5 8
8 5
3 4
2 1
3 2
1 4
8 6
0 1
5 4
6 5
6 2
3 3