3 33
 9  3  7  1  2  8  4  5  6 
 5  6  4  7  9  3  1  8  2
 8  1  2  6  4  5  9  7  3
 1  5  6  8  3  4  2  9  7
 7  2  9  5  1  6  8  3  4
 4  8  3  9  7  2  6  1  5
 6  9  8  2  5  7  3  4  1 
 3  7  1  4  6  9  5  2  8
 2  4  5  3  8  1  7  6  9

2 2
1 4
8 3
3 1
5 4
6 2
8 0
5 6
7 8
4 6
3 4
7 5
3 3
7 1
6 4
5 0
2 0
6 5
4 0
3 7
0 6
8 2
4 4
6 7
6 6
4 7
1 0
7 6
1 2
6 1
0 3
1 3
0 8