3 33
 1  5  6  8  3  9  7  4  2 
 9  4  2  6  7  5  3  1  8 
 3  8  7  1  2  4  6  5  9 
 7  9  1  2  5  3  8  6  4 
 2  3  4  9  6  8  1  7  5 
 5  6  8  4  1  7  2  9  3 
 8  7  3  5  9  1  4  2  6 
 4  2  9  7  8  6  5  3  1 
 6  1  5  3  4  2  9  8  7 

6 1
7 3
3 4
6 6
4 0
7 2
1 5
2 2
7 8
6 4
5 1
6 7
3 8
1 6
3 6
5 0
5 7
7 6
2 4
7 0
3 1
5 2
3 7
7 4
6 5
4 3
0 3
5 6
4 5
2 6
8 6
0 5
1 4