3 33
 5  6  3  2  4  1  7  9  8 
 9  8  7  3  6  5  2  4  1
 2  4  1  7  9  8  5  3  6
 7  1  4  6  8  9  3  2  5
 3  5  9  1  2  7  8  6  4
 6  2  8  4  5  3  9  1  7 
 1  7  5  9  3  6  4  8  2
 4  9  6  8  7  2  1  5  3
 8  3  2  5  1  4  6  7  9
 
8 4
7 0
0 6
5 3
4 0
8 1
8 0
6 2
7 8
1 0
4 6
7 6
7 2
4 5
8 3
0 5
1 7
6 7
5 4
6 3
8 7
0 2
0 4
5 7
5 5
4 7
2 1
4 1
8 5
2 3
0 0
7 1
0 7