3 33
 2  6  9  5  8  7  4  1  3 
 1  3  8  9  4  6  7  5  2
 7  4  5  3  1  2  6  9  8
 9  7  4  6  2  8  1  3  5
 5  2  1  7  9  3  8  6  4
 6  8  3  1  5  4  2  7  9
 8  5  7  2  3  1  9  4  6 
 4  9  6  8  7  5  3  2  1
 3  1  2  4  6  9  5  8  7

2 3
1 7
6 2
3 5
0 8
8 6
4 0
4 8
1 3
1 8
1 2
2 6
5 5
0 5
1 4
0 7
2 4
3 1
0 4
1 1
8 3
3 7
5 3
6 3
7 7
1 5
3 6
2 1
3 4
6 0
1 0
3 8
2 2