3 33
 8  4  5  3  7  2  1  6  9 
 2  6  9  4  5  1  3  8  7
 3  7  1  8  6  9  4  2  5 
 9  3  7  6  1  8  2  5  4
 1  5  2  9  4  3  6  7  8
 6  8  4  7  2  5  9  1  3
 7  2  8  1  9  4  5  3  6
 5  9  3  2  8  6  7  4  1 
 4  1  6  5  3  7  8  9  2

0 6
6 5
7 4
3 8
8 4
4 5
5 0
1 3
8 6
8 3
1 7
6 3
1 5
2 5
3 3
1 4
4 2
7 5
5 4
3 0
2 3
4 8
5 1
6 8
5 7
6 6
6 4
7 2
4 4
0 3
0 0
0 4
0 5