3 38
4 5 7 6 9 1 3 2 8
2 9 8 3 4 7 5 6 1
6 3 1 2 8 5 4 7 9
9 4 6 8 3 2 1 5 7
1 8 5 9 7 6 2 4 3
7 2 3 1 5 4 9 8 6 
3 1 4 5 6 8 7 9 2
5 6 2 7 1 9 8 3 4
8 7 9 4 2 3 6 1 5