3 40
 3  7  6  5  1  4  9  2  8 
 4  2  9  8  3  6  5  7  1
 8  5  1  9  7  2  3  4  6
 7  6  2  4  5  3  1  8  9
 9  1  3  6  2  8  4  5  7
 5  4  8  1  9  7  2  6  3
 1  9  7  2  8  5  6  3  4 
 6  3  5  7  4  1  8  9  2
 2  8  4  3  6  9  7  1  5
7 7
7 1
8 1
8 0
5 0
1 2
4 7
1 1
4 4
5 1
7 0
1 8
5 8
1 3
1 7
6 5
8 5
6 4
4 6
6 2
5 6
3 8
7 8
0 7
8 7
6 6
6 7
2 6
3 3
3 5
7 2
3 7
0 1
6 1
6 0
0 2
8 2
5 2
0 5
2 4