3 40
 1  6  9  5  8  4  3  2  7 
 7  3  8  6  1  2  5  9  4
 2  5  4  7  9  3  8  6  1
 3  8  1  9  6  7  4  5  2
 6  7  2  4  5  1  9  3  8 
 4  9  5  2  3  8  1  7  6
 8  1  7  3  2  5  6  4  9
 5  4  6  1  7  9  2  8  3
 9  2  3  8  4  6  7  1  5
 5 1
2 0
3 1
2 1
2 3
6 6
7 4
8 0
5 3
5 2
4 5
4 7
3 2
7 8
0 3
0 7
4 8
0 6
6 7
0 0
8 6
0 4
2 4
5 8
5 4
5 0
7 7
6 2
0 8
8 7
4 2
7 6
5 7
3 4
1 7
7 5
6 4
8 5
0 5
3 8