3 40
 5  4  2  1  6  9  8  7  3 
 3  1  6  5  8  7  2  4  9
 9  7  8  3  4  2  5  1  6
 7  5  9  4  1  6  3  2  8
 8  3  1  2  7  5  6  9  4
 6  2  4  8  9  3  7  5  1
 2  8  5  9  3  1  4  6  7 
 4  9  7  6  2  8  1  3  5
 1  6  3  7  5  4  9  8  2
1 2
0 8
7 7
6 2
1 6
1 1
7 4
0 7
7 2
4 4
2 2
8 0
7 6
0 4
5 8
1 5
8 5
4 0
6 0
1 4
7 0
8 4
6 3
1 0
7 3
7 8
8 2
3 4
6 4
0 1
8 8
4 2
5 7
5 5
3 3
5 4
6 6
3 8
8 1
8 3