3 39
5 6 7 4 9 8 1 3 2 
9 4 8 1 3 2 6 5 7
3 7 4 6 8 9 2 1 5
3 7 4 6 8 9 2 1 5
1 2 6 3 4 5 7 9 8
8 9 5 2 1 7 3 4 6
6 8 3 7 5 1 4 2 9
4 5 2 9 6 3 8 7 1
7 1 9 8 2 4 5 6 3

7 7
5 5
8 5
0 4
4 8
8 0
6 3
0 5
2 0
3 3
1 7
1 0
2 5
1 4
4 6
0 6
5 8
8 7
4 5
3 1
3 7
6 7
0 1
5 1
1 5
7 2
2 7
4 0
6 6
2 4
6 1
2 8
3 8
6 2
2 3
3 2
8 8
6 0
4 7