3 40
9  6  2  1  5  8  3  7  4 
4  3  5  9  7  6  2  1  8 
7  8  1  3  2  4  5  6  9 
2  4  9  8  6  1  7  5  3 
8  7  3  2  9  5  6  4  1 
1  5  6  4  3  7  8  9  2 
5  2  8  6  1  9  4  3  7 
3  9  7  5  4  2  1  8  6 
6  1  4  7  8  3  9  2  5 
0 0
3 3
0 8
4 7
3 1
4 3
2 2
7 5
8 2
3 4
6 2
5 7
2 5
6 5
8 0
6 8
7 1
4 5
1 4
2 7
6 1
5 3
4 0
1 5
0 1
0 3
5 8
0 7
7 8
5 5
2 4
7 7
5 6
4 1
2 1
4 4
8 5
1 7
0 5
6 7