3 40
4  5  2  6  3  8  9  7  1 
1  9  8  7  4  2  3  5  6
7  3  6  5  1  9  4  2  8
6  1  9  2  5  3  8  4  7
3  8  5  9  7  4  6  1  2
2  4  7  1  8  6  5  9  3
9  7  1  3  6  5  2  8  4 
5  6  4  8  2  1  7  3  9
8  2  3  4  9  7  1  6  5

1 7
6 8
7 4
8 5
0 3
8 1
5 5
8 2
5 8
2 7
0 6
7 7
2 0
4 3
5 7
7 3
8 0
6 1
6 7
4 7
1 5
0 5
3 0
8 8
6 6
2 6
6 0
4 8
6 3
7 5
5 3
1 2
1 3
7 0
8 6
8 3
3 6
4 5
5 2
1 4