3 40
 9  2  1  4  5  6  7  3  8 
 8  3  5  7  1  9  6  2  4
 4  6  7  8  3  2  1  9  5
 7  1  8  2  9  5  3  4  6
 2  4  6  3  7  1  5  8  9
 5  9  3  6  8  4  2  7  1
 3  5  2  9  6  8  4  1  7
 1  7  9  5  4  3  8  6  2 
 6  8  4  1  2  7  9  5  3
1 2
0 1
0 5
4 8
7 3
1 6
5 1
2 6
4 3
1 4
7 4
0 6
5 7
1 7
6 3
7 5
0 0
5 8
2 5
6 7
2 3
8 2
4 5
3 5
6 0
3 3
2 1
2 8
7 6
6 5
2 4
8 0
5 0
4 2
3 7
5 5
6 6
4 0
8 7
2 7