3 40  
 8  7  3  4  2  6  1  9  5 
 5  2  4  1  7  9  3  8  6
 1  6  9  5  8  3  7  4  2
 3  1  6  8  4  5  9  2  7
 9  8  2  6  1  7  5  3  4
 4  5  7  9  3  2  8  6  1
 2  4  5  3  9  1  6  7  8
 7  9  1  2  6  8  4  5  3 
 6  3  8  7  5  4  2  1  9
1 8
8 0
3 3
5 7
3 8
8 1
2 4
8 2
6 6
7 7
0 1
8 5
3 1
2 0
1 0
7 0
6 8
4 8
5 3
6 5
8 3
8 6
4 2
1 1
3 5
0 0
2 5
1 4
1 7
3 0
4 4
2 1
4 7
4 1
3 6
2 6
7 2
0 2
5 6
4 6