3 40
1 4 2 8 9 3 6 7 5
7 6 3 4 2 5 1 8 9
8 9 5 6 1 7 3 2 4
2 1 7 9 6 4 8 5 3
9 3 4 5 8 1 2 6 7
5 8 6 3 7 2 9 4 1
4 5 1 2 3 6 7 9 8
3 2 8 7 5 9 4 1 6
6 7 9 1 4 8 5 3 2

0 0 0 1 0 2 0 4 0 8
1 0 1 3 1 7 1 8 2 0 
2 2 2 7 2 8 3 0 3 5
3 6 4 1 4 5 4 6 4 7
5 1 5 4 5 5 5 6 5 7 
5 8 6 