3 40
1 2 8 6 9 4 7 3 5
5 7 3 1 8 2 9 6 4 
6 4 9 7 5 3 1 2 8
2 8 1 5 6 7 3 4 9
3 9 4 8 2 1 6 5 7
7 5 6 4 3 9 8 1 2
4 6 5 3 7 8 2 9 1
8 3 2 9 1 5 4 7 6
9 1 7 2 4 6 5 8 3

0 1 0 2 0 3 0 5 0 8
1 0 1 3 1 7 1 8
2 0 2 2 2 7 2 8
3 0 3 5 3 6
4 1 4 5 4 6 4 7
5 1 5 4 5 5 5 6 5 7 5 8
6 1 6 3 6 5 
7 1 7 2 7 5 7 6 7 7
8 2 8 3 8 4 8 5 8 6 8 7