3 29
1 2 8 6 9 4 7 3 5
5 7 3 1 8 2 9 6 4 
6 4 9 7 5 3 1 2 8
2 8 1 5 6 7 3 4 9
3 9 4 8 2 1 6 5 7
7 5 6 4 3 9 8 1 2
4 6 5 3 7 8 2 9 1
8 3 2 9 1 5 4 7 6
9 1 7 2 4 6 5 8 3