3 40
4 5 7 6 9 1 3 2 8
2 9 8 3 4 7 5 6 1
6 3 1 2 8 5 4 7 9
9 4 6 8 3 2 1 5 7
1 8 5 9 7 6 2 4 3
7 2 3 1 5 4 9 8 6 
3 1 4 5 6 8 7 9 2
5 6 2 7 1 9 8 3 4
8 7 9 4 2 3 6 1 5

0 0 0 2 0 4 0 5 0 7
0 8 1 1 1 2 1 4 1 6
2 0 2 5 3 0 3 3 3 5
3 6 4 5 4 6 4 7 4 8
5 0 5 1 5 5 5 6 5 7
5 8 6 1 6 2 6 4 6 5 
6 8 7 0 7 2 7 6 8 0
8 1 8 4 8 5 8 6 8 7