3 30
1 4 2 8 9 3 6 7 5
7 6 3 4 2 5 1 8 9
8 9 5 6 1 7 3 2 4
2 1 7 9 6 4 8 5 3
9 3 4 5 8 1 2 6 7
5 8 6 3 7 2 9 4 1
4 5 1 2 3 6 7 9 8
3 2 8 7 5 9 4 1 6
6 7 9 1 4 8 5 3 2