3 24
 3  5  1  7  4  8  2  6  9 
 6  2  9  5  3  1  4  8  7
 7  4  8  2  9  6  5  3  1 
 1  3  4  6  7  2  9  5  8
 9  8  2  1  5  4  3  7  6
 5  6  7  3  8  9  1  4  2
 4  9  3  8  1  7  6  2  5
 8  1  6  4  2  5  7  9  3
 2  7  5  9  6  3  8  1  4

0 3
8 8
1 7
6 1
1 4
7 4
6 0
2 1
4 8
2 2
7 3
0 4
4 5
4 4
6 5
3 3
1 5
5 6
3 4
6 6
0 7
3 8
6 7
5 5