3 24
 7  3  2  4  9  8  6  1  5 
 6  4  1  3  5  2  9  8  7
 8  9  5  1  7  6  2  3  4
 4  6  8  5  3  9  1  7  2
 1  7  3  2  6  4  5  9  8
 5  2  9  8  1  7  4  6  3
 3  1  7  9  4  5  8  2  6 
 2  5  6  7  8  1  3  4  9
 9  8  4  6  2  3  7  5  1

2 2
0 8
7 5
1 2
8 3
7 3
3 6
8 7
7 0
6 0
7 4
3 8
3 0
2 4
8 0
1 4
3 3
1 1
4 7
5 3
1 6
8 6
2 7
2 5