3 24
 9  1  5  7  4  3  6  2  8 
 6  8  7  9  2  1  5  4  3
 3  2  4  5  6  8  9  1  7
 7  9  2  8  1  6  3  5  4
 4  5  8  3  9  7  1  6  2
 1  3  6  2  5  4  7  8  9
 2  7  9  1  8  5  4  3  6
 8  4  1  6  3  9  2  7  5
 5  6  3  4  7  2  8  9  1 

5 8
0 6
8 6
7 0
8 2
5 5
6 5
5 3
1 3
6 3
3 1
6 0
8 5
0 7
7 3
2 7
7 1
3 8
7 7
0 0
8 7
1 1
4 3
1 2