3 24
 6  4  9  5  3  7  8  1  2 
 5  7  8  1  4  2  3  6  9
 3  2  1  8  6  9  4  7  5
 7  6  2  3  9  1  5  4  8
 9  8  5  6  7  4  2  3  1
 4  1  3  2  8  5  6  9  7
 1  3  6  9  2  8  7  5  4 
 2  5  7  4  1  3  9  8  6
 8  9  4  7  5  6  1  2  3

2 8
8 5
8 3
6 1
0 2
4 3
6 7
6 3
8 1
5 8
3 0
6 4
7 7
1 7
8 7
7 8
8 0
4 6
7 6
1 6
4 5
0 7
7 0
3 3