3 24
 1  3  5  2  6  7  9  8  4 
 2  8  6  3  4  9  7  1  5
 4  7  9  1  5  8  6  3  2
 8  5  2  6  3  4  1  7  9
 3  1  4  9  7  5  2  6  8
 9  6  7  8  1  2  4  5  3
 7  4  3  5  9  6  8  2  1
 5  9  8  7  2  1  3  4  6 
 6  2  1  4  8  3  5  9  7

4 8
4 0
7 6
2 7
0 3
0 4
5 4
3 7
0 0
4 3
2 4
0 7
7 4
7 2
7 0
3 5
2 0
1 6
6 6
6 3
6 7
4 6
3 4
3 6