3 24
 7  8  2  9  6  3  5  1  4 
 5  3  4  1  7  2  6  9  8 
 9  6  1  4  5  8  2  3  7
 6  4  8  2  1  9  7  5  3
 2  7  9  5  3  4  8  6  1
 1  5  3  7  8  6  4  2  9
 3  9  6  8  2  7  1  4  5
 4  1  7  6  9  5  3  8  2
 8  2  5  3  4  1  9  7  6 

6 2
6 8
5 2
1 5
2 0
3 3
0 5
5 7
2 4
7 4
2 2
4 7
6 3
4 5
8 2
0 4
3 0
5 4
2 8
4 1
7 0
3 5
4 8
8 6