3 24
 7  6  2  1  5  9  3  4  8 
 4  5  8  2  7  3  9  1  6
 3  9  1  6  8  4  5  7  2
 8  7  4  3  2  1  6  5  9
 6  1  9  5  4  8  2  3  7 
 2  3  5  9  6  7  4  8  1
 1  2  6  7  3  5  8  9  4
 9  4  3  8  1  2  7  6  5
 5  8  7  4  9  6  1  2  3

4 1
3 5
5 2
6 1
2 4
8 7
3 6
6 4
0 5
0 4
6 6
1 0
8 5
3 2
2 3
7 2
5 8
0 3
5 5
7 7
7 1
5 1
8 6
7 0