3 24
 9  2  1  5  6  3  7  8  4 
 8  7  3  1  2  4  9  6  5 
 6  4  5  7  8  9  2  3  1
 1  3  2  8  4  5  6  7  9
 4  9  6  3  7  2  1  5  8
 5  8  7  9  1  6  3  4  2
 7  6  8  4  9  1  5  2  3 
 2  5  9  6  3  8  4  1  7
 3  1  4  2  5  7  8  9  6

4 8
7 3
6 5
0 4
0 5
3 8
2 1
4 0
8 1
2 4
4 2
7 1
6 4
8 2
2 7
5 0
5 5
4 5
3 0
5 4
1 7
7 6
4 6
0 8