3 24
 5  4  7  9  6  2  3  8  1 
 9  6  8  3  4  1  7  5  2
 3  2  1  5  7  8  4  6  9
 8  1  4  7  2  9  6  3  5 
 6  5  2  1  8  3  9  7  4
 7  3  9  6  5  4  1  2  8
 4  7  3  2  9  5  8  1  6
 2  8  6  4  1  7  5  9  3 
 1  9  5  8  3  6  2  4  7

8 0
0 8
6 5
6 1
6 6
3 4
3 5
6 8
7 1
4 6
8 4
2 7
2 0
5 1
4 2
4 4
5 0
3 6
1 8
5 8
2 4
2 2
8 2
3 8