3 24
 7  5  4  8  2  6  1  3  9 
 3  1  9  4  5  7  2  8  6
 2  6  8  9  1  3  7  5  4
 1  9  7  2  3  5  4  6  8
 8  4  6  1  7  9  3  2  5
 5  2  3  6  4  8  9  7  1 
 9  8  2  7  6  4  5  1  3
 4  3  1  5  8  2  6  9  7
 6  7  5  3  9  1  8  4  2

2 3
7 6
7 4
5 2
0 1
1 6
3 6
6 0
5 1
7 7
7 3
6 7
6 1
2 8
5 6
3 8
3 3
8 5
1 8
0 6
5 5
4 6
3 2
0 7