3 26
 1  4  3  7  6  8  2  5  9 
 8  2  9  3  4  5  7  1  6
 5  6  7  2  9  1  3  8  4
 2  9  5  1  8  3  6  4  7 
 7  1  4  6  5  2  8  9  3
 3  8  6  9  7  4  1  2  5
 9  7  8  5  2  6  4  3  1 
 4  5  1  8  3  7  9  6  2
 6  3  2  4  1  9  5  7  8

0 6
0 3
2 1
8 7
6 0
8 4
5 2
4 1
6 5
5 6
8 3
8 2
6 3
0 0
1 5
8 5
6 6
3 0
1 0
2 0
4 8
6 1
5 3
8 1
4 7
7 2