3 26
 1  3  7  2  9  5  6  8  4 
 8  9  4  1  3  6  7  5  2 
 6  5  2  7  4  8  1  9  3
 3  6  5  4  8  7  9  2  1 
 2  1  8  3  6  9  4  7  5
 7  4  9  5  2  1  8  3  6
 4  7  1  8  5  3  2  6  9
 9  8  3  6  1  2  5  4  7
 5  2  6  9  7  4  3  1  8 

4 1
1 2
7 0
0 6
8 5
3 5
2 7
0 0
8 0
5 2
8 6
8 1
1 4
5 8
2 8
6 8
4 5
4 3
3 6
1 5
7 1
0 7
5 0
7 2
2 1
0 3