3 26
 5  3  2  4  7  6  1  9  8 
 9  1  7  2  8  5  6  3  4
 6  8  4  9  3  1  7  5  2
 7  2  6  1  5  3  4  8  9
 8  4  5  7  6  9  3  2  1
 3  9  1  8  2  4  5  7  6
 1  7  9  3  4  2  8  6  5
 2  5  8  6  1  7  9  4  3
 4  6  3  5  9  8  2  1  7

1 3
6 6
8 1
7 0
2 6
4 3
0 0
4 1
3 2
3 8
5 0
5 8
8 6
7 2
2 7
1 0
4 7
1 4
5 4
7 6
2 1
7 8
7 4
3 7
2 3
3 0