3 26
 9  2  5  4  8  6  7  3  1 
 6  7  1  9  2  3  8  5  4
 3  8  4  7  5  1  9  2  6 
 4  5  2  1  6  7  3  8  9
 1  3  8  5  9  4  6  7  2 
 7  6  9  8  3  2  1  4  5
 8  9  3  2  1  5  4  6  7
 2  1  7  6  4  8  5  9  3
 5  4  6  3  7  9  2  1  8

1 8
6 2
0 7
6 4
3 7
0 2
2 2
2 8
5 1
5 8
3 2
4 5
1 5
1 3
2 4
1 2
0 6
0 8
7 3
6 5
5 5
2 1
4 6
6 8
5 4
4 8