 3 26
 5  2  1  8  6  9  4  7  3 
 7  4  8  3  1  5  2  6  9
 9  3  6  2  4  7  1  5  8
 2  1  5  7  8  4  3  9  6
 4  8  9  6  3  1  7  2  5
 6  7  3  5  9  2  8  4  1
 1  9  2  4  5  8  6  3  7 
 8  6  7  9  2  3  5  1  4
 3  5  4  1  7  6  9  8  2

5 4
7 6
3 8
7 7
5 7
4 5
3 0
0 5
6 0
6 7
4 8
1 0
5 8
0 3
2 4
7 5
5 3
6 3
3 5
6 5
4 6
3 3
8 7
8 6
4 3
5 2