3 26
 2  8  7  5  6  1  4  3  9 
 3  5  9  2  8  4  7  6  1
 4  6  1  7  9  3  8  5  2 
 7  4  8  6  2  5  9  1  3
 9  1  2  3  7  8  6  4  5
 5  3  6  1  4  9  2  7  8
 6  7  5  9  1  2  3  8  4
 8  2  3  4  5  6  1  9  7
 1  9  4  8  3  7  5  2  6

0 1
2 2
2 7
4 1
8 8
8 0
3 4
4 7
5 6
3 8
0 6
2 1
7 2
0 8
3 1
4 2
3 2
8 7
4 8
2 3
4 4
6 2
3 3
6 7
2 5
8 1