3 26
 3  7  1  8  2  4  6  5  9 
 2  9  4  5  6  1  3  8  7
 5  6  8  9  7  3  1  2  4
 4  1  7  3  8  5  9  6  2
 9  8  3  6  4  2  7  1  5
 6  2  5  1  9  7  8  4  3
 8  5  6  2  3  9  4  7  1
 7  3  2  4  1  8  5  9  6
 1  4  9  7  5  6  2  3  8 

7 4
3 5
8 8
7 8
4 5
5 2
0 8
8 5
2 5
0 3
0 4
4 3
2 7
5 3
7 1
8 7
8 2
6 4
2 1
0 6
1 4
4 2
6 6
0 1
4 0
1 6