3 26
 3  2  4  8  1  7  9  5  6 
 9  5  6  2  4  3  8  7  1
 7  8  1  6  5  9  3  4  2
 4  1  7  3  8  2  6  9  5 
 5  9  8  4  6  1  2  3  7
 6  3  2  7  9  5  4  1  8
 1  4  9  5  2  6  7  8  3
 8  6  3  1  7  4  5  2  9
 2  7  5  9  3  8  1  6  4

3 1
1 1
0 4
5 7
2 8
4 6
3 6
1 2
6 1
6 6
0 1
7 2
8 7
6 5
0 7
3 7
2 2
2 6
2 4
7 5
6 2
8 3
1 8
4 4
1 5
4 2