3 26
 8  3  5  2  9  1  4  6  7 
 4  7  2  6  3  8  5  1  9
 1  9  6  5  4  7  8  2  3
 6  2  4  3  7  9  1  5  8
 5  8  7  4  1  2  9  3  6
 9  1  3  8  6  5  7  4  2
 2  4  8  9  5  3  6  7  1
 7  5  9  1  2  6  3  8  4
 3  6  1  7  8  4  2  9  5 

6 2
7 0
1 3
4 1
3 0
2 3
8 1
5 7
0 7
6 0
8 5
5 2
3 5
2 4
4 7
8 0
7 4
2 1
4 6
6 7
7 3
4 8
5 1
0 8
7 8
3 1