3 26
 9  8  5  4  3  7  2  1  6 
 7  1  6  9  2  5  8  4  3 
 3  2  4  6  1  8  7  9  5 
 6  3  8  2  4  9  1  5  7 
 1  4  7  5  6  3  9  8  2 
 5  9  2  8  7  1  6  3  4 
 4  7  9  3  8  6  5  2  1 
 2  5  1  7  9  4  3  6  8 
 8  6  3  1  5  2  4  7  9 

5 3
6 7
6 8
4 3
5 8
4 8
1 1
5 7
0 6
0 3
5 1
1 0
5 5
3 1
8 0
2 2
1 8
3 5
5 6
6 1
7 4
8 8
0 0
0 2
2 3